10 10
9111111119
1111111111
1111111111
1111111111
1111oO1111
1111Oo1111
1111111111
1111111111
1111111111
9111111119
