8 8
51111115
11111111
11111111
111oO111
111Oo111
11111111
11111111
91111119
