10 10
8111111115
1111111111
1111111111
1111111111
1111oO1111
1111Oo1111
1111111111
1111111111
1111111111
8111111115
