10 10
5179159124
4178432486
5977578951
7867698944
2633oO5395
6383Oo6637
7115256927
7565931345
7932648444
9838853696
